Name	letter	three_letter	property
Asparagine	N	Asn	polar
Glutamine	Q	Gln	polar
Serine	S	Ser	polar
Threonine	T	Thr	polar
Tyrosine	Y	Tyr	polar
Alanine	A	Ala	nonpolar
Cysteine	C	Cys	nonpolar
Glycine	G	Gly	nonpolar
Isoleucine	I	Ile	nonpolar
Leucine	L	Leu	nonpolar
Methionine	M	Met	nonpolar
Phenylalanine	F	Phe	nonpolar
Proline	P	Pro	nonpolar
Tryptophan	W	Trp	nonpolar
Valine	V	Val	nonpolar
Arginine	R	Arg	basic polar
Histidine	H	His	basic polar
Lysine	K	Lys	basic polar
Aspartic acid 	D	Asp	acidic polar
Glutamic acid 	E	Glu	acidic polar
